{
  "width": 30,
  "height": 20,
  "ground": [
    [0,1,0,1,0,1,0,1,0,1,0,1,0,1,0,1,0,1,0,1],
    [1,0,1,0,1,0,1,0,1,0,1,0,1,0,1,0,1,0,1,0],
    [0,1,0,1,0,1,0,1,0,1,0,1,0,1,0,1,0,1,0,1],
    [1,0,1,0,1,0,1,0,1,0,1,0,1,0,1,0,1,0,1,0],
    [0,1,0,1,0,1,0,1,0,1,0,1,0,1,0,1,0,1,0,1],
    [1,0,1,0,1,0,1,0,1,0,1,0,1,0,1,0,1,0,1,0],
    [0,1,0,1,0,1,0,1,0,1,0,1,0,1,0,1,0,1,0,1],
    [1,0,1,0,1,0,1,0,1,0,1,0,1,0,1,0,1,0,1,0],
    [0,1,0,1,0,1,0,1,0,1,0,1,0,1,0,1,0,1,0,1],
    [1,0,1,0,1,0,1,0,1,0,1,0,1,0,1,0,1,0,1,0]
  ],
  "objects": [
    [0,0,0,0,0,0,0,0,0,0,0,0,0,0,0,0,0,0,0,0],
    [0,0,0,0,4,0,0,0,4,0,0,0,0,0,0,0,0,0,0,0],
    [0,0,0,0,0,0,0,0,0,0,0,3,0,0,0,0,0,0,0,0],
    [0,0,0,0,4,0,0,0,4,0,0,0,0,0,0,0,0,0,0,0],
    [0,0,0,0,0,0,0,0,0,0,0,0,0,0,0,0,0,0,0,0],
    [0,0,0,0,0,0,0,0,0,0,0,0,0,0,3,0,0,0,0,0],
    [0,0,0,0,0,0,0,0,0,0,0,0,0,0,4,0,0,0,0,0],
    [0,0,0,0,0,0,0,0,0,0,0,0,0,0,4,0,0,0,0,0],
    [0,0,0,0,0,0,0,0,0,0,0,0,0,0,4,0,3,0,0,0],
    [0,0,0,0,0,0,0,0,0,0,0,0,0,0,0,0,0,0,5,0]
  ],
  "playerStart": { "x": 11, "y": 10 }
}
