{
  "width": 10,
  "height": 6,
  "ground": [
    [0, 1, 0, 1, 0, 1, 0, 1, 0, 1],
    [1, 0, 1, 0, 1, 0, 1, 0, 1, 0],
    [0, 1, 0, 1, 0, 1, 0, 1, 0, 1],
    [1, 0, 1, 0, 1, 0, 1, 0, 1, 0],
    [0, 1, 0, 1, 0, 1, 0, 1, 0, 1],
    [1, 0, 1, 0, 1, 0, 1, 0, 1, 0]
  ],
  "objects": [
    [0, 0, 0, 0, 4, 0, 0, 0, 0, 0],
    [0, 0, 0, 0, 0, 3, 0, 4, 0, 0],
    [0, 0, 0, 0, 4, 0, 0, 0, 0, 0],
    [0, 0, 3, 0, 0, 0, 0, 0, 0, 0],
    [0, 4, 4, 4, 5, 0, 0, 0, 3, 0],
    [0, 0, 0, 0, 0, 0, 0, 0, 0, 0]
  ],
  "playerStart": { "x": 6, "y": 2 }
}
