{
  "width": 10,
  "height": 10,
  "ground": [
    [0,0,0,0,0,0,0,0,0,0],
    [0,1,1,1,1,1,1,1,1,0],
    [0,1,0,0,0,0,0,0,1,0],
    [0,1,0,1,1,1,1,0,1,0],
    [0,1,0,1,0,0,1,0,1,0],
    [0,1,0,1,0,0,1,0,1,0],
    [0,1,0,1,1,1,1,0,1,0],
    [0,1,0,0,0,0,0,0,1,0],
    [0,1,1,1,1,1,1,1,1,0],
    [0,0,0,0,0,0,0,0,0,0]
  ],
  "objects": [
    [0,0,0,0,0,0,0,0,0,0],
    [0,4,0,0,0,0,0,0,2,0],
    [0,0,0,4,0,0,4,0,0,0],
    [0,0,3,0,0,0,0,3,0,0],
    [0,0,0,0,2,0,0,0,0,0],
    [0,0,4,0,0,5,0,4,0,0],
    [0,3,0,0,0,0,0,0,2,0],
    [0,0,0,4,0,0,4,0,0,0],
    [0,2,0,0,0,3,0,0,0,4],
    [0,0,0,0,0,0,0,0,0,0]
  ],
  "playerStart": { "x": 1, "y": 8 }
}
